0, 0, 0, 9, 0, 0, 0, 3, 0
3, 0, 6, 0, 2, 0, 0, 4, 0
2, 0, 4, 0, 0, 3, 1, 0, 6
0, 7, 0, 0, 5, 1, 0, 8, 0
0, 3, 1, 0, 6, 0, 0, 5, 7
5, 0, 9, 0, 0, 0, 6, 0, 0
4, 1, 0, 0, 0, 2, 0, 7, 8
7, 6, 3, 0, 0, 5, 4, 0, 0
9, 2, 8, 0, 0, 4, 0, 0, 1