4, 8, 9, 2, 3, 0, 7, 0, 6
2, 7, 0, 5, 8, 0, 3, 9, 1
0, 0, 0, 6, 9, 0, 0, 4, 0
7, 6, 0, 0, 4, 3, 0, 0, 0
0, 0, 0, 0, 7, 0, 0, 1, 0
0, 9, 5, 0, 0, 2, 0, 0, 3
5, 0, 0, 0, 0, 9, 0, 0, 0
0, 0, 0, 0, 2, 0, 5, 0, 7
0, 4, 7, 0, 0, 0, 1, 2, 0